100XB0000000XX000
0H0H0H0H0H0H0H0HB
X00XXX0XX00X000X0
0H0H0H0HBH0H0H0H0
X000X0000X000000X
0H0H0H0H0H0HXH0H0
0000B0X000XX00X0X
0H0H0HXH0HXHXHXH0
B00000XX00XXX0XX0
0H0H0H0H0HXH0H0HX
X00X000000X0XX000
0H0HXH0H0HXHXH0H0
B0000XX00B00X00XE
