10X0X0XXB000XXX00
0H0H0H0H0H0H0H0H0
000X0X000XX00X00X
0H0H0H0H0HXH0H0H0
XB00XX000X0B000X0
0H0H0H0HXH0H0H0H0
B0000X0XB00000X0X
XH0H0HXHXHXHXHXH0
00X0000000XXX00XX
0H0H0H0HXHXH0H0HX
0000000B00XXX0X0X
0H0H0H0H0H0H0H0HX
000BXXX00X0X0X0XE
