10XB0000000000000
0H0H0H0HXH0H0H0H0
X00X00X0000BX00XX
0H0HXH0H0H0HXHXH0
00X000X0XX000X00B
XHXH0H0H0H0H0H0H0
B0000XX0X00X00XXX
0H0H0HBHXH0H0H0H0
X00X00000X0X0000X
0H0H0HXH0H0H0HXH0
0XB000X0X000X00X0
XHXHXH0HXH0H0H0H0
0000XXB00X00X000E